-------------------------------------------------
-------------------------------------------------
-------------------------------------------------
-------------------------------------------------
-------------------------------------------------
-------------------------------------------------
-------------------------------------------------
-------------------------------------------------
-------------------------------------------------
------- BBBBBBBBBBBBBBBBBBBBBBBBB----------------
------- B------------------B----B----------------
------- B------------------B----B----------------
------- B------------------BBBBBB----------------
------- B------------------B---------------------
------- B------------------B---------------------
------- B------------------B-------WWWWWW--------
------- B------------------B-------WWWWWW--------
------- B------------------B-------WWWWWW--------
------- B------------------B-------WWWWWW--------
------- B------------------B-------WWWWWW--------
------- BBBBBBBBBBBBBBBBBBBB---------------------
-------------------------------------------------
-------------------------------------------------
-------------------------------------------------
-------------------------------------------------
-------------------------------------------------
-------------------------------------------------
--------BBBBBBBBBBB-----------BBBBBBBBB----------
--------B---------B-----------B-------B----------
--------B---------B-----------B-------B----------
--------B---------B-----------B-------B----------
--------B---------B-----------B-------B----------
--------B---------B----------MBBBBBBBBBM---------
--------B---------B----------MMMMMMMMMMM---------
--------B---------B----------MMMMMMMMMMM---------
--------B---------B----------MBBBBBBBBBM---------
--------B---------B-----------B-------B----------
--------B---------B-----------B-------B----------
--------B---------B-----------B-------B----------
--------BBBBBBBBBBB-----------B-------B----------
------------------------------BBBBBBBBB----------
-------------------------------------------------
-------------------------------------------------
-------------------------------------------------
-------------------------------------------------
-------------------------------------------------
-------------------------------------------------
-------------------------------------------------
-------------------------------------------------
-------------------------------------------------